TTTTTTTT
TXXXXXXT
T------T
T------T
T------T
T------T
T------T
T------T
TTTTTTTT
XXXXXXXX