TTTTTTTT
TXXXXXXT
T-----TT
E------T
T---O--T
T---A--T
D--I---T
T-1----T
TTTTTTTT
OOOOOOOO