YYYYYYYY
YMMMMMMY
Y------Y
Y------Y
Y------Y
Y------Y
Y------Y
Y------Y
YYYYYYYY
MMMMMMMM