YYYYYYYY
YMMMMMMY
Y------Y
C------Y
Y------Y
Y------Y
B------Y
Y------Y
YYYYYYYY
MMMMMMMM