xxxxxxxxxxxxxxxxxxxxxxxxxxxxx
x--x--------------------x---x
x---------------------------x
x---------------------------x
x------x--------------------x
x---------------------------x
x---------------------------x
x---------------------------x
x----------------x----------x
x---------------------------x
x---------------------------x
x---------------------------x
x--------x------------------x
x---------------------------x
xxxxxxxxxxxxxxxxxxxxxxxxxxxxx