TTTTTTTT
TXXXXXXT
T-----TT
E------T
T---O--T
T---A--T
D--*---T
T------T
TTTTTTTT
OOOOOOOO