TTTTTTTT
TXXXXXXT
T-----TT
T------T
T------T
T------T
T------T
T------T
TTTTTTTT
XXXXXXXX